A I I I I I I I I I I I I I X X X B B B X X X B B B B B B B
I X X I X I X I X I X X X I X B B B X B B B X B X B X B X B
I I X I I I X I I I I I X I X B X B X B X B X B B B X B X B
X I I I X I X X I X X I I I X B B B X B X B X B X B B B X B
X X I X X I X X I X I I X I X B X B X B B B B B X B X X X B
I I I I I I I I I X I X X I V B X B X B X X X B X B B B B B
I X X X X I X X I X I X X I X X X B B B B B B B B B X X B X
I X I I I I X X I I I I I I X B B B X B X X X B X B X X B B
I I I X X I I I I X I X X I X B X X X B B B B B X B X X X B
I X I X X X X I X X I X X I X B X B B B X X X B X B B B B B
I I I I I I I I I I I I I I X B B B X B B B B B B B X X X X
X X X X X X X X X X X X X X X X X X X X X X W X X X X X X X
B F B X B B B B B B B X B B B B X C C C C X C X C C C C C C
B X B B B X B X X X B B B X X B W C X X C C C X C X C X X C
B B B X B B B B B B B X B B B B X C X X C X X X C C C X X C
B X X X B X X X X B X X X X X X X C X C C C C C C X C X X C
B X X X B X B B B B X C C C C C C C C C X X X X C X C C C C
B B B B B B B X X B X C X C X X X C X X X C C C C X X X X C
B X B X X X B X X B X C X C C C X C C C C C X X C X X X X C
B B B X X X B B B B X C C C X C C C X X C C C C C C C C C C